{
  "tiles": [
    " VV                             ",
    " VV    =   =  =  =  = = =  = =  ",
    " VV                             ",
    "          VV                    ",
    "          VV                    ",
    "        bbVV                    ",
    "           |                    ",
    "           |                    ",
    "           |                    ",
    "                                ",
    "                                ",
    "                                ",
    "                                ",
    "   ============                 ",
    "                                ",
    "                                ",
    "                                ",
    "                                ",
    "================================"
  ]
}
