{
  "tiles": [
    "                                ",
    "                                ",
    "                                ",
    "                                ",
    "           V   V                ",
    "           V   V                ",
    "           V   V                ",
    "  BB       |  bV                ",
    "  BB       |  bV    z  z    z   ",
    "  z         zzz                 ",
    "                                ",
    "                                ",
    "                                ",
    "   ============                 ",
    "                                ",
    "                                ",
    "                                ",
    "                                ",
    "================================"
  ]
}
