{
  "tiles": [
    "                                ",
    "                                ",
    "                                ",
    "                                ",
    "                   BB           ",
    "            V      BB           ",
    "            V                   ",
    "        V   V   V               ",
    "        V   V   V zz  zz   z    ",
    "          z   z   z zz z  z     ",
    "                                ",
    "                                ",
    "                                ",
    "   ============                 ",
    "                                ",
    "                                ",
    "                                ",
    "                                ",
    "================================"
  ]
}
