{
  "tiles": [
    "                                                                         X   ",
    "                                                                         X   ",
    "                                                                         X   ",
    "                                                                b        X   ",
    "                                                X                    b   X   ",
    "                                                X                        X   ",
    "                                                X                        |   ",
    "                                                X                        |   ",
    "                z            V       BB         X               V    V   |   ",
    "                             V       BB      =  X               V    V   |   ",
    "   XXXXXXXXXXXXX                                                             ",
    "                                                                             ",
    "                                                                             ",
    "                                                                             ",
    "                                                                             ",
    "                                                                             ",
    "                                                                             ",
    "                                                                             ",
    "================================"
  ]
}
