{
  "tiles": [
    "                                ",
    "                                ",
    "                                ",
    "                                ",
    "                                ",
    "     z     z    z      z   z    ",
    "     z     z    z      z   z    ",
    "                                ",
    "                                ",
    "                                ",
    "                                ",
    "                                ",
    "                                ",
    "   ============                 ",
    "                                ",
    "                                ",
    "                                ",
    "                                ",
    "================================"
  ]
}
