{
  "tiles": [
    "              b    b     =      ",
    "                         =      ",
    "                         =      ",
    "                 =       =      ",
    "                 =       =      ",
    "                         =      ",
    "                         |      ",
    "      BB         V  BB   |      ",
    "      BB         V  BB   |      ",
    "          z   z   z zz z  z     ",
    "                                ",
    "                                ",
    "                                ",
    "   ============                 ",
    "                                ",
    "                                ",
    "                                ",
    "                                ",
    "================================"
  ]
}
