{
  "tiles": [
    "                                         |                          ",
    "                                         |                          ",
    "                                         |                          ",
    "          V                              |                          ",
    "          VV                             |                          ",
    "        bb V                             |                          ",
    "           |                             |                          ",
    "           |BB   V  V  V                 |   VBB                    ",
    "           |BB   V  V  V       b      b  |   VBB                    ",
    "  z                                      |                          ",
    "  z                                      |                          ",
    "                                         |                          ",
    "                                         |                          ",
    "   ============                          |                          ",
    "                                         |                          ",
    "                                         |                          ",
    "                                         |                          ",
    "                                         |                          ",
    "================================                                    "
  ]
}
