{
  "tiles": [
    " VV                             ",
    " VV    =   =  =  =  = = =  = =  ",
    " VV                             ",
    "          V                     ",
    "          VV                    ",
    "        bb V                    ",
    "           |                    ",
    "           |BB   V              ",
    "           |BB   V              ",
    "  z                             ",
    "  z                             ",
    "                                ",
    "                                ",
    "   ============                 ",
    "                                ",
    "                                ",
    "                                ",
    "                                ",
    "================================"
  ]
}
