{
  "tiles": [
    "                                ",
    "                                ",
    "                                 ",
    "           =V     BB     BB     ",
    "        V   V     BB     BB     ",
    "        V   V                   ",
    "        V   V                   ",
    "            V                   ",
    "      BB    V    z z  z  z  z   ",
    "      BB   =V  z  z  z z  z     ",
    "                                ",
    "                                ",
    "                                ",
    "   ============                 ",
    "                                ",
    "                                ",
    "                                ",
    "                                ",
    "================================"
  ]
}
