{
  "tiles": [
    " VV                             ",
    " VV    =   =  =  =  = = =  = =  ",
    " VV                             ",
    "          V                     ",
    "          VV                    ",
    "        bb V                    ",
    "           |                    ",
    "           |BB                  ",
    "           |BB                  ",
    "  z                             ",
    "  z                             ",
    "                                ",
    "                                ",
    "   ============                 ",
    "                                ",
    "                                ",
    "                                ",
    "                                ",
    "================================"
  ]
}
