{
  "tiles": [
    " V                              ",
    " V     =   =  =  =  = = =  = =  ",
    " V                              ",
    "          V                     ",
    "          V                     ",
    "          V                     ",
    "                                ",
    "                                ",
    "                                ",
    "                                ",
    "                                ",
    "                                ",
    "                                ",
    "   ============                 ",
    "                                ",
    "                                ",
    "                                ",
    "                                ",
    "================================"
  ]
}
